You're driving home from work, tired from a long day of writing for your local newspaper. You notice a garage sale in a green house and decide to take a look at what's being sold. Nothing there interests you; it's mostly worn out books and ripped clothes. Just as you're ready to leave, a dusty black typewriter catches your eye. Mr Baker, the man running the garage sale, sells it to you for $5. You arrive home and put the typewriter on a large wooden table in your living room. You're intrigued by your new purchase but you're also exhausted from a nonstop work day. You examine the typewriter; a few sheets of paper are already placed in it and the ink is half full. After yawning one last time, you head up to bed.

Ink
An Interactive Fiction by Brennan
Release 1 / Serial number 141024 / Inform 7 build 6L38 (I6/v6.33 lib 6/12N) SD

Living Room
Your living room is very clean, but, only because you just moved into this house a few weeks ago. A dusty black typewriter sits on a large wooden table.

>put booba on table
You can't see any such thing.

>put the booba on the table
You can't see any such thing.

* * *

>up
Attic
attic description

>down
Living Room
Your living room is very clean, but only because you just moved in to this house a few weeks ago. A large wooden table fills the room.

>s
Not every direction holds something of value. Go in another direction.

>n
Not every direction holds something of value. Go in another direction.

>e
Not every direction holds something of value. Go in another direction.

>w
Not every direction holds something of value. Go in another direction.

>down
Not every direction holds something of value. Go in another direction.

>not up
That's not a verb I recognise.

>up
Not every direction holds something of value. Go in another direction.

* * *

>down
Living Room
Your living room is very clean, but only because you just moved in to this house a few weeks ago. A large wooden table fills the room.

>x ladder
You can't see any such thing.

>look
Living Room
You love the living room. You live in it.

>take ladder
You can't see any such thing.

>up
Attic below the Living Room
You climb up the dusty ladder into the dark attic.

You can see a ladder here.

>take ladder
That's fixed in place.

* * *

>up
Attic
attic description

>get on ladd3r
You can't see any such thing.

>get on ladder
You can't go that way.

>climb on ladder
You can't see any such thing.

>walk up ladder
I only understood you as far as wanting to walk up.

>walk up
You can't go that way.

>use ladder
That's not a verb I recognise.

>step on ladder
That's not a verb I recognise.

* * *

>up
Attic
attic description

>x ladder
The ladder is made of wood. It's sturdy enough to carry you up to the attic and back down to the living room.

>down
Not every direction holds something of value. Go in another direction.

>up
You can't go that way.

* * *

>x typewriter
The typewriter is coated with a thin layer of dust. Besides a few small scratches, the body of the typewriter is black as coal. A small stack of eggshell-colored stationery is placed in the typewriter's paper table. Its keys look worn and are a faded gold color. The keys need to be pushed very hard to type anything.

Two papers have been printed out that you know you didn't type. It's as if the typewriter wrote it all by itself. The first paper is titled "Instructions Paper". The second paper reads:

Find me a shiny red alarm clock from the General Store. I need to use some of its parts.

This has to have been written by the typewriter!

>read instructions paper
The paper is titled "INSTRUCTIONS" and reads: You can ask me about nearly anything. I don't guarantee that I will always give you an answer. I'm here to help you learn, therefore, I do not wish to answer questions that ask questions like "where is it?" or "what is it?". I much prefer to answer questions that ask about things. If you want to know what something is, then, ask me about what it is. If you want to know where something is, ask me about where it is.

>ask typewriter about alarm clock
There is no reply.

>l
Living Room
Your living room is very clean, but, only because you just moved into this house a few weeks ago. A dusty black typewriter sits on a large wooden table.

>x table
The table is made of dark oak wood. On the table is a typewriter.

>n
Front of the General Store
From where you stand in front of the General Store, it looks like something out of the 1950s. A little bell is tied with a string to the doorknob of its front door. The front door protrudes out from the store almost like a tunnel; the top of the door is covered in bird poop and something shiny. Through the big windows at the front of the store you can see a security guard, sleeping in the dark.

>talk to security guard
That's not a verb I recognise.

>wake up the security guard
You can't see any such thing.

>x security guar
You can't see any such thing.

>x security guard
You can't see any such thing.

>open door
It isn't something you can open.

>enter general store
You can't see any such thing.

>s
Living Room
Your living room is very clean, but, only because you just moved into this house a few weeks ago. A dusty black typewriter sits on a large wooden table.

>n
Front of the General Store
From where you stand in front of the General Store, it looks like something out of the 1950s. A little bell is tied with a string to the doorknob of its front door. The front door protrudes out from the store almost like a tunnel; the top of the door is covered in bird poop and something shiny. Through the big windows at the front of the store you can see a security guard, sleeping in the dark.

>e
Green House
You bought the typewriter at this house. It's called the "Green House" by your neighbors, presumably because the entire house is painted green.

>n
Back Porch
The back porch of the Green House is covered in cobwebs. The air smells strongly of birds; if you closed your eyes you might think you were looking at flamingos at the zoo. The little grass that is on the ground is dead.

>x grass
The grass is mostly dead except for a few living blades of grass here and there. Lying on the grass is a wooden spoon.

>take wooden spoon
Taken.

>x wooden spoon
The spoon is about as long as your hand and made of cheap wood. The handle of the spoon reads "FOR USE WITH INK ONLY"

>x cobwebs
Translucent white spider webs cover almost everything in the back porch of the green house.

>smell
You smell nothing unexpected.

>s
Green House
You bought the typewriter at this house. It's called the "Green House" by your neighbors, presumably because the entire house is painted green.

>southwest
Living Room
Your living room is very clean, but, only because you just moved into this house a few weeks ago. A dusty black typewriter sits on a large wooden table.

>n
Front of the General Store
From where you stand in front of the General Store, it looks like something out of the 1950s. A little bell is tied with a string to the doorknob of its front door. The front door protrudes out from the store almost like a tunnel; the top of the door is covered in bird poop and something shiny. Through the big windows at the front of the store you can see a security guard, sleeping in the dark.

>east
Green House
You bought the typewriter at this house. It's called the "Green House" by your neighbors, presumably because the entire house is painted green.

>w
Front of the General Store
From where you stand in front of the General Store, it looks like something out of the 1950s. A little bell is tied with a string to the doorknob of its front door. The front door protrudes out from the store almost like a tunnel; the top of the door is covered in bird poop and something shiny. Through the big windows at the front of the store you can see a security guard, sleeping in the dark.

>w
Purple House
The Purple House is the only other house on the street besides the Green House that is described by its owner's choice of paint color. The house is small and plump like the woman who has lived there for longer than anybody can remember, Mrs Bloom.

Mrs Bloom is your small, kind, neighbor. Like the typewriter, she only really likes to answer direct questions about things. Her first name is Marsa but she likes being called "Mrs" (with no dot) for short. She is working in front of the house.

>talk to mrs bloom
That's not a verb I recognise.

>ask mrs bloom about typewriter
There is no reply.

>ask mrs bloom about green house
There is no reply.

>e
Front of the General Store
From where you stand in front of the General Store, it looks like something out of the 1950s. A little bell is tied with a string to the doorknob of its front door. The front door protrudes out from the store almost like a tunnel; the top of the door is covered in bird poop and something shiny. Through the big windows at the front of the store you can see a security guard, sleeping in the dark.

>ring bell
That's not a verb I recognise.

>x front door
The door is painted a drab brown color and protrudes out from the store almost like a tunnel; the top of the door is covered in bird poop and something shiny. Besides the bell attached to the doorknob, the only shine on the door is a bright red color on the top of the door.

>x color
You can't see any such thing.

>x bell
The bell is a faded gold color; it's drab like the rest of the door and the doorknob it's attached to.

>x top of door
You can't see any such thing.

>x bird poop
You can't see any such thing.

>take alarm clock
Taken.

>x shine
Upon closer inspection of the bright red shine, you see the clock! It wasn't even in the store! You grab the clock and take it with you.

>x bright shine
Upon closer inspection of the bright red shine, you see the clock! It wasn't even in the store! You grab the clock and take it with you.

>x bright color
I only understood you as far as wanting to examine the bright red shine.

>n
You turn the doorknob and start to walk inside. The little bell tied to the doorknob wakes the sleeping guard who shoos you outside and locks the door

>s
Living Room
Your living room is very clean, but, only because you just moved into this house a few weeks ago. A dusty black typewriter sits on a large wooden table.

>give typewriter alarm clock
The typewriter clicks and clacks with joy. You have succeeded in your first mission. You may want to examine the typewriter closely once again

>x typewriter
The typewriter is coated with a thin layer of dust. Besides a few small scratches, the body of the typewriter is black as coal. A small stack of eggshell-colored stationery is placed in the typewriter's paper table. Its keys look worn and are a faded gold color. The keys need to be pushed very hard to type anything.

Another paper has been printed out that you know you didn't type. The paper reads:

I need you to bring me purple ink. You will need to go to a house painted the same color. A house of a different color will tell you where to administer it to me. This house is the same house that I was purchased from. When you've learned how to use the purple ink, return and do what you've been taught.

>northeast
Green House
You bought the typewriter at this house. It's called the "Green House" by your neighbors, presumably because the entire house is painted green.

>e
Not every direction holds something of value. Go in another direction.

>inventory
You are carrying:
  a wooden spoon

>x self
You're a journalist for your local newspaper. You can usually be found wearing a checkered jacket and a pair of glasses.

>w
Front of the General Store
From where you stand in front of the General Store, it looks like something out of the 1950s. A little bell is tied with a string to the doorknob of its front door. The front door protrudes out from the store almost like a tunnel; the top of the door is covered in bird poop and something shiny. Through the big windows at the front of the store you can see a security guard, sleeping in the dark.

* * *

>w
Purple House
The Purple House is the only other house on the street besides the Green House that is described by its owner's choice of paint color. The house is small and plump like the woman who has lived there for longer than anybody can remember, Mrs Bloom.

Mrs Bloom is your small, kind, neighbor. Like the typewriter, she only really likes to answer direct questions about things. Her first name is Marsa but she likes being called "Mrs" (with no dot) for short. She is working in front of the house.

>ask mrs bloom about ink
"Oh, that reminds me!", she says, "I have all this leftover purple ink from my custom dyed stationery paper and I was looking for somebody who might want to use it. You're a writer, right? Here, take it!"

She hands you a jar of purple ink. "I'll see you later", she says as she continues her work.

>inventory
You are carrying:
  a jar of purple ink
  a wooden spoon

>e
Front of the General Store
From where you stand in front of the General Store, it looks like something out of the 1950s. A little bell is tied with a string to the doorknob of its front door. The front door protrudes out from the store almost like a tunnel; the top of the door is covered in bird poop and something shiny. Through the big windows at the front of the store you can see a security guard, sleeping in the dark.

>e
Green House
You bought the typewriter at this house. It's called the "Green House" by your neighbors, presumably because the entire house is painted green.

* * *

>n
Back Porch
The back porch of the Green House is covered in cobwebs. The air smells strongly of birds; if you closed your eyes you might think you were looking at flamingos at the zoo. The little grass that is on the ground is dead.

>s
Green House
You bought the typewriter at this house. It's called the "Green House" by your neighbors, presumably because the entire house is painted green.

>ask mr baker about ink
Ah, hello there. What did you say? Ah... never mind. I remember you from the garage sale. I meant to tell you something about your typewriter - particularly the ink. If you have purple ink, you need to get a special wooden spoon and mix the ink. After that, put the mixed ink on whatever surface your typewriter is on and it'll do the rest. You'll find a special spoon somewhere in my back porch. Feel free to take it.

>southwest
Living Room
Your living room is very clean, but, only because you just moved into this house a few weeks ago. A dusty black typewriter sits on a large wooden table.

>put ink on table
You put the jar of purple ink on the large wooden table.

>take ink
Taken.

>give typewriter ink
The dusty black typewriter doesn't seem interested.

>mix ink with spoon
You begin mixing the ink. It looks as if nothing is happening but you continue to mix despite observing this. After what seems like a long time, you take a closer look at the jar you're mixing and notice it is now labeled "JAR OF MIXED INK". Perfect! Now you can put it on the table!

>put ink on table
    *** The typewriter does not react after you place the mixed ink on the table. It does not click. It does not clack. Nothing happens. It's as if it's at peace. ***

Would you like to RESTART, RESTORE a saved game, QUIT or UNDO the last command?

>restart
You're driving home from work, tired from a long day of writing for your local newspaper. You notice a garage sale in a green house and decide to take a look at what's being sold. Nothing there interests you; it's mostly worn out books and ripped clothes. Just as you're ready to leave, a dusty black typewriter catches your eye. Mr Baker, the man running the garage sale, sells it to you for $5. You arrive home and put the typewriter on a large wooden table in your living room. You're intrigued by your new purchase but you're also exhausted from a nonstop work day. You examine the typewriter; a few sheets of paper are already placed in it and the ink is half full. After yawning one last time, you head up to bed.

Ink
An Interactive Fiction by Brennan
Release 1 / Serial number 141024 / Inform 7 build 6L38 (I6/v6.33 lib 6/12N) SD

Living Room
Your living room is very clean, but, only because you just moved into this house a few weeks ago. A dusty black typewriter sits on a large wooden table.

>nw
Purple House
The Purple House is the only other house on the street besides the Green House that is described by its owner's choice of paint color. The house is small and plump like the woman who has lived there for longer than anybody can remember, Mrs Bloom.

Mrs Bloom is your small, kind, neighbor. Like the typewriter, she only really likes to answer direct questions about things. Her first name is Marsa but she likes being called "Mrs" (with no dot) for short. She is working in front of the house.

>e
Front of the General Store
From where you stand in front of the General Store, it looks like something out of the 1950s. A little bell is tied with a string to the doorknob of its front door. The front door protrudes out from the store almost like a tunnel; the top of the door is covered in bird poop and something shiny. Through the big windows at the front of the store you can see a security guard, sleeping in the dark.

* * *

>e
Green House
You bought the typewriter at this house. It's called the "Green House" by your neighbors, presumably because the entire house is painted green.

>w
Front of the General Store
From where you stand in front of the General Store, it looks like something out of the 1950s. A little bell is tied with a string to the doorknob of its front door. The front door protrudes out from the store almost like a tunnel; the top of the door is covered in bird poop and something shiny. Through the big windows at the front of the store you can see a security guard, sleeping in the dark.

* * *

>mix this
You can't see any such thing.

>mix table with that
You can't see any such thing.

>nw
Purple House
The Purple House is the only other house on the street besides the Green House that is described by its owner's choice of paint color. The house is small and plump like the woman who has lived there for longer than anybody can remember, Mrs Bloom.

Mrs Bloom is your small, kind, neighbor. Like the typewriter, she only really likes to answer direct questions about things. Her first name is Marsa but she likes being called "Mrs" (with no dot) for short. She is working in front of the house.

>ask mrs bloom about ink
"Oh, that reminds me!", she says, "I have all this leftover purple ink from my custom dyed stationery paper and I was looking for somebody who might want to use it. You're a writer, right? Here, take it!"

She hands you a jar of purple ink. "I'll see you later", she says as she continues her work.

>ii
That's not a verb I recognise.

>i
You are carrying:
  a jar of purple ink

I beg your pardon?

>e
Front of the General Store
From where you stand in front of the General Store, it looks like something out of the 1950s. A little bell is tied with a string to the doorknob of its front door. The front door protrudes out from the store almost like a tunnel; the top of the door is covered in bird poop and something shiny. Through the big windows at the front of the store you can see a security guard, sleeping in the dark.

* * *

>n
Back Porch
The back porch of the Green House is covered in cobwebs. The air smells strongly of birds; if you closed your eyes you might think you were looking at flamingos at the zoo. The little grass that is on the ground is dead.

>take spoon
Taken.

>i
You are carrying:
  a wooden spoon
  a jar of purple ink

>s
Green House
You bought the typewriter at this house. It's called the "Green House" by your neighbors, presumably because the entire house is painted green.

>sw
Living Room
Your living room is very clean, but, only because you just moved into this house a few weeks ago. A dusty black typewriter sits on a large wooden table.

>mix ink with spoon
You begin mixing the ink. It looks as if nothing is happening but you continue to mix despite observing this. After what seems like a long time, you take a closer look at the jar you're mixing and notice it is now labeled "JAR OF MIXED INK". Perfect! Now you can put it on the table!

>i
You are carrying:
  a jar of mixed ink

>put jar of mixed on table
    *** cool ***

Would you like to RESTART, RESTORE a saved game, QUIT or UNDO the last command?

* * *

>climb ladder
I don't think much is to be achieved by that.

>go up
You can't go that way.

>up
You can't go that way.

>x ladder
The ladder is made of wood. It's sturdy enough to carry you up to the attic and back down to the living room.

>up
You can't go that way.

>n
General Store
The General Store sells like everything.

>s
Living Room
Your living room is very clean, but only because you just moved in to this house a few weeks ago. A large wooden table fills the room along with a ladder leading up to the attic.

>u
You can't go that way.

>up
You can't go that way.

* * *

>ask typewriter about chicken
There is no reply.

* * *

>ask the typewriter about chicken
There is no reply.

>ask typewriter about chicken
There is no reply.

>ask the dusty black typewriter about Chiken
There is no reply.

* * *

>ne
Green House
You bought the typewriter at this house. It's called the "Green House" by your neighbors, presumably because the entire house is painted green.

>n
Back Porch
The back porch of the Green House is covered in cobwebs. The air smells strongly of birds; if you closed your eyes you might think you were looking at flamingos at the zoo. The little grass that is on the ground is dead.

* * *

>take spoon
Taken.

>i
You are carrying:
  a wooden spoon

>x spoon
The spoon is about as long as your hand and made of cheap wood. The handle of the spoon reads "FOR USE WITH INK ONLY"

>s
Green House
You bought the typewriter at this house. It's called the "Green House" by your neighbors, presumably because the entire house is painted green. The front door and even the window above it are painted green.

>w
Front of the General Store
From where you stand in front of the General Store, it looks like something out of the 1950s. A little bell is tied with a string to the doorknob of its front door. Through the big windows at the front of the store you can see a security guard, sleeping in the dark.

You can see a Front Door here.

>n
Not every direction holds something of value. Go in another direction.

* * *

>take spoon
Taken.

>s
Green House
You bought the typewriter at this house. It's called the "Green House" by your neighbors, presumably because the entire house is painted green.

* * *

>sw
Living Room
Your living room is very clean, but, only because you just moved into this house a few weeks ago. A dusty black typewriter sits on a large wooden table.

>put spoon on table
You put the wooden spoon on the large wooden table.

>i
You are carrying nothing.

>x table
The table is made of dark oak wood. On the table is a typewriter.

On the large wooden table is a wooden spoon.

* * *

>ask about topic 1
You hear a faint hum. The typewriter begins to rattle, slowly at first then faster and faster. The paper starts to move on its own. The keys are clacking loudly like rain hitting the pavement.

>ask about topic a
You hear a faint hum. The typewriter begins to rattle, slowly at first then faster and faster. The paper starts to move on its own. The keys are clacking loudly like rain hitting the pavement.

topic a response

>ask about chicken
You hear a faint hum. The typewriter begins to rattle, slowly at first then faster and faster. The paper starts to move on its own. The keys are clacking loudly like rain hitting the pavement.

* * *

>mix
That's not a verb I recognise.

* * *

>n
Front of the General Store
From where you stand in front of the General Store, it looks like something out of the 1950s. A little bell is tied with a string to the doorknob of its front door. The front door protrudes out from the store almost like a tunnel; the top of the door is covered in bird poop and something shiny. Through the big windows at the front of the store you can see a security guard, sleeping in the dark.

>w
Purple House
The Purple House is the only other house on the street besides the Green House that is described by its owner's choice of paint color. The house is small and plump like the woman who has lived there for longer than anybody can remember, Mrs Bloom.

>ask Mrs Bloom about chicken
There is no reply.

>ask Mrs Bloom about ink
"Oh, that reminds me!", she says, "I have all this leftover purple ink from my custom dyed stationery paper and I was looking for somebody who might want to use it. You're a writer, right? Here, take it!"

She hands you a jar of purple ink.

>ask Mrs Bloom about purple ink
"Oh, that reminds me!", she says, "I have all this leftover purple ink from my custom dyed stationery paper and I was looking for somebody who might want to use it. You're a writer, right? Here, take it!"

She hands you a jar of purple ink.

>i
You are carrying:
  a jar of purple ink

* * *

>n
Front of the General Store
From where you stand in front of the General Store, it looks like something out of the 1950s. A little bell is tied with a string to the doorknob of its front door. The front door protrudes out from the store almost like a tunnel; the top of the door is covered in bird poop and something shiny. Through the big windows at the front of the store you can see a security guard, sleeping in the dark.

>n
You turn the doorknob and start to walk inside. The little bell tied to the doorknob wakes the sleeping guard who shoos you outside and locks the door

>x top of front door
You can't see any such thing.

>type something
That's not a verb I recognise.

>s
Living Room
Your living room is very clean, but, only because you just moved into this house a few weeks ago. A dusty black typewriter sits on a large wooden table.

>type something
That's not a verb I recognise.

>ne
Green House
You bought the typewriter at this house. It's called the "Green House" by your neighbors, presumably because the entire house is painted green.

>ask mr baker about cats
Ah, hello there. What did you say? Ah... never mind. I remember you from the garage sale. I meant to tell you something about your typewriter - particularly the ink. If you have purple ink, you need to take a special wooden spoon and mix the ink until it becomes black ink. After that, just pour the black ink into the typewriter. You'll find a spoon like that somewhere in my back porch.

>ask mr baker about chicken
Hey, I'm a busy old man. Just grab the spoon from my back porch and mix your ink.

>n
Back Porch
The back porch of the Green House is covered in cobwebs. The air smells strongly of birds; if you closed your eyes you might think you were looking at flamingos at the zoo. The little grass that is on the ground is dead.

* * *

>s
Green House
You bought the typewriter at this house. It's called the "Green House" by your neighbors, presumably because the entire house is painted green.

>w
Front of the General Store
From where you stand in front of the General Store, it looks like something out of the 1950s. A little bell is tied with a string to the doorknob of its front door. The front door protrudes out from the store almost like a tunnel; the top of the door is covered in bird poop and something shiny. Through the big windows at the front of the store you can see a security guard, sleeping in the dark.

* * *

>ask mrs bloom about ink
"Oh, that reminds me!", she says, "I have all this leftover purple ink from my custom dyed stationery paper and I was looking for somebody who might want to use it. You're a writer, right? Here, take it!"

She hands you a jar of purple ink. "I'll see you later", she says as she continues her work.

>i
You are carrying:
  a jar of purple ink
  a wooden spoon

>se
Living Room
Your living room is very clean, but, only because you just moved into this house a few weeks ago. A dusty black typewriter sits on a large wooden table.

* * *

>n
Front of the General Store
From where you stand in front of the General Store, it looks like something out of the 1950s. A little bell is tied with a string to the doorknob of its front door. The front door protrudes out from the store almost like a tunnel; the top of the door is covered in bird poop and something shiny. Through the big windows at the front of the store you can see a security guard, sleeping in the dark.

>take clock
Taken.

>i
You are carrying:
  a shiny red alarm clock

>s
Living Room
Your living room is very clean, but, only because you just moved into this house a few weeks ago. A dusty black typewriter sits on a large wooden table.

>give clock to typewriter
The typewriter clicks and clacks with joy. You have succeeded in your first mission. You may want to examine the typewriter closely once again

>i
You are carrying nothing.