Game Description
Ink
An Interactive Fiction by Brennan
Release 1 / Serial number 141014 / Inform 7 build 6L38 (I6/v6.33 lib 6/12N) SD

Living Room
You love the living room. You live in it.

You can see a ladder here.

>x ladder
You can't see any such thing.

>up
Attic
You climb up the dusty ladder into the dark attic.

>take ladder
That's fixed in place.

* * *

>up
Attic
You climb up the dusty ladder into the dark attic.

>x ladder
You can't see any such thing.

>take ladder
That's hardly portable.

>up
Attic
You climb up the dusty ladder into the dark attic.

* * *

Game Description
Ink
An Interactive Fiction by Brennan
Release 1 / Serial number 141014 / Inform 7 build 6L38 (I6/v6.33 lib 6/12N) SD

Living Room
You love the living room. You live in it.

You can see a ladder here.

>n
General Store
The General Store sells like everything.

>s
Living Room
You love the living room. You live in it.

>up
Attic
You climb up the dusty ladder into the dark attic.

You can see a ladder here.

* * *

>s
Living Room
You love the living room. You live in it.

>nw
Purple House
Mrs. Bloom is so nice. She lives in the purple house.

>e
General Store
The General Store sells like everything.

>s
Living Room
You love the living room. You live in it.

>n
General Store
The General Store sells like everything.

>w
Purple House
Mrs. Bloom is so nice. She lives in the purple house.

>e
General Store
The General Store sells like everything.

>e
Green House
This is the house where you bought the typewriter.

>sw
Living Room
You love the living room. You live in it.

>ne
Green House
This is the house where you bought the typewriter.

>n
Back Porch
The back porch is dusty.

>s
Green House
This is the house where you bought the typewriter.

>w
General Store
The General Store sells like everything.

>w
Purple House
Mrs. Bloom is so nice. She lives in the purple house.

>we
That's not a verb I recognise.

>se
Living Room
You love the living room. You live in it.

* * *

Game Description
Ink
An Interactive Fiction by Brennan
Release 1 / Serial number 141014 / Inform 7 build 6L38 (I6/v6.33 lib 6/12N) SD

Living Room
You love the living room. You live in it.

You can see a ladder here.

>up
Attic below the Living Room
You climb up the dusty ladder into the dark attic.

You can see a ladder here.

>down
Living Room
You love the living room. You live in it.

>x ladder
You can't see any such thing.

* * *

Game Description
Ink
An Interactive Fiction by Brennan
Release 1 / Serial number 141014 / Inform 7 build 6L38 (I6/v6.33 lib 6/12N) SD

Living Room
You love the living room. You live in it.

You can see a ladder here.

>look
Living Room
You love the living room. You live in it.

* * *

Game Description
Ink
An Interactive Fiction by Brennan
Release 1 / Serial number 141014 / Inform 7 build 6L38 (I6/v6.33 lib 6/12N) SD

Living Room
You love the living room. You live in it.

You can see a ladder here.

>above
That's not a verb I recognise.