You're driving home from work, tired from a long day of writing for your local newspaper. You notice a garage sale in a green house and decide to take a look at what's being sold. Nothing there interests you; it's mostly worn out books and ripped clothes. Just as you're ready to leave, a dusty black typewriter catches your eye. Mr. Baker, the man running the garage sale, sells it to you for $5. You arrive home and put the typewriter on a large wooden table in your living room. You're intrigued by your new purchase but you're also exhausted from a nonstop work day. You examine the typewriter; a few sheets of paper are already placed in it and the ink is half full. After yawning one last time, you head up to bed.

Ink
An Interactive Fiction by Brennan
Release 1 / Serial number 141024 / Inform 7 build 6L38 (I6/v6.33 lib 6/12N) SD

Living Room
Your living room is very clean, but, only because you just moved into this house a few weeks ago. A dusty black typewriter sits on a large wooden table.

>up
Attic
attic description

* * *

>above
That's not a verb I recognise.

>go above
You can't see any such thing.

>go up
Attic
You climb up the dusty ladder into the dark attic.

>down
Living Room
You love the living room. You live in it.

>climb up
You must name something more substantial.

* * *

>take typewriter
I don't suppose the dusty black typewriter would care for that.

* * *

>look
Living Room
You love the living room. You live in it.

>go up ladder
I only understood you as far as wanting to go up.

>ladder
That's not a verb I recognise.

>x ladder
You can't see any such thing.

* * *

>ask typewriter about chicken
this is example

>ask typewriter about Chicken
There is no reply.

>ask the dusty black typewriter about Chicken
There is no reply.

>ask about Chicken
chicken response

* * *

>take all
Wake up! You must've dozed off and had a dream that you could just take everything in a room at once.

>i
You are carrying nothing.

* * *

>x the first paper
The paper is titled "INSTRUCTIONS" and reads: You can ask me about nearly anything. I don't guarantee that I will always give you an answer. I'm here to help you learn, therefore, I do not wish to answer questions that ask questions like "where is it?" or "what is it?". I much prefer to answer questions that ask about things. If you want to know what something is, then, ask me about what it is. If you want to know where something is, ask me about where it is.

>x first paper
You can't see any such thing.

>x paper
The paper is titled "INSTRUCTIONS" and reads: You can ask me about nearly anything. I don't guarantee that I will always give you an answer. I'm here to help you learn, therefore, I do not wish to answer questions that ask questions like "where is it?" or "what is it?". I much prefer to answer questions that ask about things. If you want to know what something is, then, ask me about what it is. If you want to know where something is, ask me about where it is.

* * *

>x table
large wooden table description

>x countertop
large wooden table description

>x counter top
I only understood you as far as wanting to examine the large wooden table.

>x large table
large wooden table description

>x big table
You can't see any such thing.

* * *

>ask typewriter where the key is
You can't see any such thing.

>ask where the key is
You can't see any such thing.

>ask about where the key is
You can't see any such thing.

* * *

>s
Bedroom
bed + room = bedroom!

* * *

>x big table
You can't see any such thing.

>x big wooden table
large wooden table description

* * *

>climb ladder
I don't think much is to be achieved by that.

* * *

>ask typewriter chicken
You can't see any such thing.

* * *

>nw
Purple House
The Purple House is the only other house on the street besides the Green House that is described by its owner's choice of paint color. The house is small and plump like the woman who has lived there for longer than anybody can remember, Mrs Bloom.

>ask mrs bloom about purple ink
"Oh, that reminds me!", she says, "I have all this leftover purple ink from my custom dyed stationery paper and I was looking for somebody who might want to use it. You're a writer, right? Here, take it!"

She hands you a jar of purple ink.

>i
You are carrying:
  a jar of purple ink

>Ask Mrs Bloom about purple ink
I'm busy now, sorry! You already have the jar of purple ink!

* * *

>ask about topic 1
You hear a faint hum. The typewriter begins to rattle, slowly at first then faster and faster. The paper starts to move on its own. The keys are clacking loudly like rain hitting the pavement.

* * *

>x typewriter
The typewriter is coated with a thin layer of dust. Besides a few small scratches, the body of the typewriter is black as coal. A small stack of eggshell-colored stationery is placed in the typewriter's paper table. The keys look worn and are a faded gold color. The keys need to be pushed very hard to type anything.

Two papers have been printed out that you know you didn't type. It's as if the typewriter wrote it all by itself. The first paper is titled "Instructions Paper". The second paper reads:

Locked inside me is something very valuable. At the bottom of my body is a keyhole that will allow you to retrieve it.  I'm certain you'll like what you find.

These papers had to have been written by the typewriter!

>n
Front of the General Store
From where you stand in front of the General Store, it looks like something out of the 1950s. A little bell is tied with a string to the doorknob of its front door. Through the big windows at the front of the store you can see a security guard, sleeping in the dark.

>enter store
You can't see any such thing.

>go inside
Not every direction holds something of value. Go in another direction.

* * *

>n
Front of the General Store
From where you stand in front of the General Store, it looks like something out of the 1950s. A little bell is tied with a string to the doorknob of its front door. Through the big windows at the front of the store you can see a security guard, sleeping in the dark.

You can see a Front Door here.

>w
Purple House
The Purple House is the only other house on the street besides the Green House that is described by its owner's choice of paint color. The house is small and plump like the woman who has lived there for longer than anybody can remember, Mrs Bloom.